//MAP CONVERTED BY dmm2tgm.py THIS HEADER COMMENT PREVENTS RECONVERSION, DO NOT REMOVE
"dl" = (
/obj/structure/cable,
/obj/machinery/door/airlock/external/ruin{
	name = "Mining Shuttle External Airlock"
	},
/obj/effect/mapping_helpers/airlock/cyclelink_helper,
/turf/open/floor/iron/shuttle/exploration/textured_flat,
/area/shuttle/mining/large/advanced)
"dN" = (
/turf/closed/wall/mineral/titanium/shuttle_wall/mining_large{
	icon_state = "2,1"
	},
/area/shuttle/mining/large/advanced)
"eI" = (
/turf/closed/wall/mineral/titanium/shuttle_wall/mining_large,
/area/shuttle/mining/large/advanced)
"gl" = (
/obj/effect/turf_decal/shuttle/exploration/hazardstripe,
/obj/effect/turf_decal/shuttle/exploration/hazardstripe{
	dir = 1
	},
/obj/effect/turf_decal/shuttle/exploration/airlock,
/obj/structure/cable,
/turf/open/floor/iron/shuttle/exploration,
/area/shuttle/mining/large/advanced)
"hn" = (
/obj/machinery/computer/shuttle/mining,
/obj/effect/turf_decal/shuttle/exploration/hazardstripe,
/turf/open/floor/iron/shuttle/exploration/blanktile,
/area/shuttle/mining/large/advanced)
"iL" = (
/turf/closed/wall/mineral/titanium/shuttle_wall/mining_large{
	icon_state = "6,4"
	},
/area/shuttle/mining/large/advanced)
"iN" = (
/obj/effect/turf_decal/shuttle/exploration/hazardstripe,
/obj/structure/cable,
/turf/open/floor/iron/shuttle/exploration/blanktile,
/area/shuttle/mining/large/advanced)
"jP" = (
/turf/closed/wall/mineral/titanium/shuttle_wall/mining_large{
	icon_state = "4,1"
	},
/area/shuttle/mining/large/advanced)
"kU" = (
/obj/structure/railing{
	dir = 8
	},
/obj/structure/closet/crate/internals,
/obj/item/pickaxe/drill/compact,
/obj/item/clothing/head/utility/hardhat/orange{
	name = "protective hat";
	pixel_y = 9
	},
/obj/item/clothing/head/utility/hardhat/orange{
	name = "protective hat";
	pixel_y = 9
	},
/obj/item/clothing/head/utility/hardhat/orange{
	name = "protective hat";
	pixel_y = 9
	},
/obj/item/tank/internals/emergency_oxygen/double,
/obj/item/tank/internals/emergency_oxygen/double,
/obj/item/tank/internals/emergency_oxygen/double,
/obj/item/clothing/mask/breath{
	pixel_x = -3;
	pixel_y = -3
	},
/obj/item/clothing/mask/breath{
	pixel_x = -3;
	pixel_y = -3
	},
/obj/item/clothing/mask/breath{
	pixel_x = -3;
	pixel_y = -3
	},
/obj/item/clothing/suit/hazardvest{
	desc = "A high-visibility lifejacket complete with whistle and slot for oxygen tanks.";
	name = "emergency lifejacket"
	},
/obj/item/clothing/suit/hazardvest{
	desc = "A high-visibility lifejacket complete with whistle and slot for oxygen tanks.";
	name = "emergency lifejacket"
	},
/obj/item/clothing/suit/hazardvest{
	desc = "A high-visibility lifejacket complete with whistle and slot for oxygen tanks.";
	name = "emergency lifejacket"
	},
/obj/item/clothing/suit/hazardvest{
	desc = "A high-visibility lifejacket complete with whistle and slot for oxygen tanks.";
	name = "emergency lifejacket"
	},
/obj/item/clothing/head/utility/hardhat/orange{
	name = "protective hat";
	pixel_y = 9
	},
/obj/item/clothing/mask/breath{
	pixel_x = -3;
	pixel_y = -3
	},
/obj/item/tank/internals/emergency_oxygen/double,
/turf/open/floor/iron/shuttle/exploration/equipmentrail3{
	dir = 4
	},
/area/shuttle/mining/large/advanced)
"mX" = (
/turf/closed/wall/mineral/titanium/shuttle_wall/mining_large{
	icon_state = "1,1"
	},
/area/shuttle/mining/large/advanced)
"ne" = (
/turf/open/floor/iron/shuttle/exploration/equipmentrail2{
	dir = 8
	},
/area/shuttle/mining/large/advanced)
"nE" = (
/turf/closed/wall/mineral/titanium/shuttle_wall/mining_large{
	icon_state = "0,6"
	},
/area/shuttle/mining/large/advanced)
"nQ" = (
/obj/structure/railing{
	dir = 8
	},
/turf/open/floor/iron/shuttle/exploration/equipmentrail1{
	dir = 4
	},
/area/shuttle/mining/large/advanced)
"pa" = (
/obj/structure/railing{
	dir = 8
	},
/turf/open/floor/iron/shuttle/exploration/equipmentrail2{
	dir = 4
	},
/area/shuttle/mining/large/advanced)
"pe" = (
/turf/closed/wall/mineral/titanium/shuttle_wall/window/mining_large{
	icon_state = "1,0"
	},
/area/shuttle/mining/large/advanced)
"pA" = (
/turf/closed/wall/mineral/titanium/shuttle_wall/window/mining_large,
/area/shuttle/mining/large/advanced)
"rw" = (
/turf/closed/wall/mineral/titanium/shuttle_wall/mining_large{
	icon_state = "1,9"
	},
/area/shuttle/mining/large/advanced)
"rM" = (
/turf/closed/wall/mineral/titanium/shuttle_wall/mining_large{
	icon_state = "6,1"
	},
/area/shuttle/mining/large/advanced)
"sG" = (
/turf/closed/wall/mineral/titanium/shuttle_wall/mining_large{
	icon_state = "0,9"
	},
/area/shuttle/mining/large/advanced)
"sM" = (
/turf/closed/wall/mineral/titanium/shuttle_wall/mining_large{
	icon_state = "4,0"
	},
/area/shuttle/mining/large/advanced)
"sQ" = (
/obj/structure/cable,
/turf/open/floor/iron/shuttle/exploration/blanktile,
/area/shuttle/mining/large/advanced)
"ts" = (
/obj/structure/cable,
/obj/machinery/door/airlock/external/ruin{
	name = "Mining Shuttle External Airlock"
	},
/obj/effect/mapping_helpers/airlock/cyclelink_helper{
	dir = 1
	},
/obj/docking_port/mobile{
	shuttle_id = "mining";
	name = "mining shuttle";
	port_direction = 2
	},
/obj/structure/fans/tiny/forcefield,
/turf/open/floor/iron/shuttle/exploration/flat,
/area/shuttle/mining/large/advanced)
"xr" = (
/obj/structure/ore_box,
/turf/open/floor/iron/shuttle/exploration/equipmentrail1{
	dir = 8
	},
/area/shuttle/mining/large/advanced)
"yQ" = (
/turf/closed/wall/mineral/titanium/shuttle_wall/mining_large{
	icon_state = "5,1"
	},
/area/shuttle/mining/large/advanced)
"zb" = (
/obj/structure/cable,
/obj/machinery/light/small/directional/south,
/turf/open/floor/iron/shuttle/exploration/blanktile,
/area/shuttle/mining/large/advanced)
"Cq" = (
/turf/closed/wall/mineral/titanium/shuttle_wall/window/mining_large{
	icon_state = "6,0"
	},
/area/shuttle/mining/large/advanced)
"Dt" = (
/turf/closed/wall/mineral/titanium/shuttle_wall/mining_large{
	icon_state = "2,0"
	},
/area/shuttle/mining/large/advanced)
"ER" = (
/obj/item/stack/ore/iron,
/obj/item/stack/ore/iron{
	pixel_x = -2;
	pixel_y = -8
	},
/turf/open/floor/iron/shuttle/exploration/equipmentrail2{
	dir = 8
	},
/area/shuttle/mining/large/advanced)
"ET" = (
/turf/closed/wall/mineral/titanium/shuttle_wall/window/mining_large{
	icon_state = "0,3"
	},
/area/shuttle/mining/large/advanced)
"Gl" = (
/obj/item/stack/ore/iron{
	pixel_x = 6;
	pixel_y = 4
	},
/obj/structure/railing{
	dir = 8
	},
/turf/open/floor/iron/shuttle/exploration/equipmentrail2{
	dir = 4
	},
/area/shuttle/mining/large/advanced)
"Gv" = (
/turf/closed/wall/mineral/titanium/shuttle_wall/mining_large{
	icon_state = "4,2";
	dir = 4
	},
/area/shuttle/mining/large/advanced)
"Ir" = (
/turf/open/floor/iron/shuttle/exploration/equipmentrail3{
	dir = 8
	},
/area/shuttle/mining/large/advanced)
"Iv" = (
/obj/effect/decal/cleanable/dirt,
/turf/open/floor/iron/shuttle/exploration/blanktile,
/area/shuttle/mining/large/advanced)
"ID" = (
/turf/closed/wall/mineral/titanium/shuttle_wall/mining_large{
	icon_state = "6,5"
	},
/area/shuttle/mining/large/advanced)
"IG" = (
/obj/structure/table/reinforced,
/obj/item/radio/intercom,
/obj/effect/turf_decal/shuttle/exploration/hazardstripe,
/turf/open/floor/iron/shuttle/exploration/blanktile,
/area/shuttle/mining/large/advanced)
"IX" = (
/turf/closed/wall/mineral/titanium/shuttle_wall/mining_large{
	icon_state = "6,6"
	},
/area/shuttle/mining/large/advanced)
"IY" = (
/turf/closed/wall/mineral/titanium/shuttle_wall/window/mining_large{
	icon_state = "0,0"
	},
/area/shuttle/mining/large/advanced)
"Jw" = (
/turf/closed/wall/mineral/titanium/shuttle_wall/mining_large{
	icon_state = "6,7"
	},
/area/shuttle/mining/large/advanced)
"KF" = (
/turf/closed/wall/mineral/titanium/shuttle_wall/mining_large{
	icon_state = "0,4"
	},
/area/shuttle/mining/large/advanced)
"KR" = (
/turf/closed/wall/mineral/titanium/shuttle_wall/mining_large{
	icon_state = "6,9"
	},
/area/shuttle/mining/large/advanced)
"LL" = (
/turf/closed/wall/mineral/titanium/shuttle_wall/mining_large{
	icon_state = "0,5";
	dir = 1
	},
/area/shuttle/mining/large/advanced)
"LO" = (
/obj/effect/turf_decal/shuttle/exploration/bot,
/obj/machinery/power/apc/auto_name/directional/east,
/obj/structure/cable,
/obj/effect/decal/cleanable/dirt,
/turf/open/floor/iron/shuttle/exploration/hazard,
/area/shuttle/mining/large/advanced)
"NL" = (
/obj/structure/table/reinforced,
/obj/item/folder/yellow,
/obj/item/pen,
/obj/item/storage/medkit/regular,
/obj/item/storage/toolbox/emergency,
/obj/item/stock_parts/cell/high,
/turf/open/floor/iron/shuttle/exploration/blanktile,
/area/shuttle/mining/large/advanced)
"Oa" = (
/turf/closed/wall/mineral/titanium/shuttle_wall/mining_large{
	icon_state = "4,2"
	},
/area/shuttle/mining/large/advanced)
"Of" = (
/obj/machinery/light/small/directional/south,
/turf/open/floor/iron/shuttle/exploration/blanktile,
/area/shuttle/mining/large/advanced)
"Pw" = (
/turf/closed/wall/mineral/titanium/shuttle_wall/window/mining_large{
	icon_state = "0,3";
	dir = 4
	},
/area/shuttle/mining/large/advanced)
"QT" = (
/turf/closed/wall/mineral/titanium/shuttle_wall/mining_large{
	icon_state = "6,8"
	},
/area/shuttle/mining/large/advanced)
"Rb" = (
/turf/closed/wall/mineral/titanium/shuttle_wall/mining_large{
	icon_state = "0,7"
	},
/area/shuttle/mining/large/advanced)
"Rj" = (
/turf/closed/wall/mineral/titanium/shuttle_wall/mining_large{
	icon_state = "0,1"
	},
/area/shuttle/mining/large/advanced)
"Rx" = (
/turf/closed/wall/mineral/titanium/shuttle_wall/mining_large{
	icon_state = "6,2"
	},
/area/shuttle/mining/large/advanced)
"TL" = (
/obj/effect/turf_decal/shuttle/exploration/bot,
/obj/structure/closet/shuttle/mining{
	dir = 1
	},
/turf/open/floor/iron/shuttle/exploration/uside{
	dir = 1
	},
/area/shuttle/mining/large/advanced)
"Ur" = (
/obj/structure/chair/comfy/shuttle{
	dir = 1
	},
/obj/effect/turf_decal/shuttle/exploration/bot,
/turf/open/floor/iron/shuttle/exploration/blanktile,
/area/shuttle/mining/large/advanced)
"UF" = (
/turf/closed/wall/mineral/titanium/shuttle_wall/mining_large{
	icon_state = "0,8"
	},
/area/shuttle/mining/large/advanced)
"US" = (
/obj/structure/chair/comfy/shuttle{
	dir = 4
	},
/obj/effect/turf_decal/shuttle/exploration/bot,
/turf/open/floor/iron/shuttle/exploration/blanktile,
/area/shuttle/mining/large/advanced)
"Wv" = (
/turf/closed/wall/mineral/titanium/shuttle_wall/mining_large{
	icon_state = "0,2"
	},
/area/shuttle/mining/large/advanced)
"WR" = (
/turf/closed/wall/mineral/titanium/shuttle_wall/mining_large{
	icon_state = "5,9"
	},
/area/shuttle/mining/large/advanced)
"YH" = (
/turf/open/floor/iron/shuttle/exploration/blanktile,
/area/shuttle/mining/large/advanced)
"ZS" = (
/turf/closed/wall/mineral/titanium/shuttle_wall/window/mining_large{
	icon_state = "5,0"
	},
/area/shuttle/mining/large/advanced)

(1,1,1) = {"
sG
UF
Rb
nE
LL
KF
ET
Wv
Rj
IY
"}
(2,1,1) = {"
rw
NL
US
US
Gv
US
Iv
TL
mX
pe
"}
(3,1,1) = {"
Pw
IG
YH
YH
YH
YH
Of
eI
dN
Dt
"}
(4,1,1) = {"
Pw
hn
Ur
YH
YH
YH
iN
dl
gl
ts
"}
(5,1,1) = {"
Pw
kU
Gl
pa
nQ
YH
zb
Oa
jP
sM
"}
(6,1,1) = {"
WR
xr
ER
ne
Ir
YH
sQ
LO
yQ
ZS
"}
(7,1,1) = {"
KR
QT
Jw
IX
ID
iL
pA
Rx
rM
Cq
"}
