//MAP CONVERTED BY dmm2tgm.py THIS HEADER COMMENT PREVENTS RECONVERSION, DO NOT REMOVE
"a" = (
/obj/machinery/power/shuttle_engine/propulsion{
	dir = 8
	},
/turf/open/floor/plating/airless,
/area/shuttle/supply)
"b" = (
/obj/docking_port/mobile/supply{
	dir = 1
	},
/obj/machinery/door/airlock/grunge{
	name = "Supply Shuttle Airlock";
	req_access = list("cargo")
	},
/obj/effect/turf_decal/delivery/white,
/turf/open/floor/iron/dark/textured_large,
/area/shuttle/supply)
"i" = (
/obj/effect/turf_decal/tile/neutral/diagonal_edge,
/obj/effect/turf_decal/box/white/corners{
	dir = 4
	},
/obj/effect/decal/cleanable/dirt,
/turf/open/floor/iron/dark/diagonal,
/area/shuttle/supply)
"l" = (
/obj/structure/fluff/metalpole/end{
	pixel_x = -32;
	dir = 8
	},
/turf/closed/wall/mineral/titanium/spaceship/nodiagonal,
/area/shuttle/supply)
"m" = (
/turf/closed/wall/mineral/titanium/nodiagonal,
/area/shuttle/supply)
"o" = (
/obj/effect/turf_decal/tile/neutral/diagonal_edge,
/obj/effect/decal/cleanable/dirt,
/turf/open/floor/iron/dark/diagonal,
/area/shuttle/supply)
"s" = (
/obj/machinery/door/airlock/grunge{
	name = "Supply Shuttle Airlock";
	req_access = list("cargo")
	},
/obj/effect/turf_decal/delivery/white,
/turf/open/floor/iron/dark/textured_large,
/area/shuttle/supply)
"u" = (
/obj/effect/decal/cleanable/dirt,
/obj/machinery/light/directional/north,
/turf/open/floor/iron/shuttle/cargo,
/area/shuttle/supply)
"w" = (
/obj/machinery/power/shuttle_engine/heater{
	dir = 8
	},
/turf/closed/wall/mineral/titanium/spaceship/nodiagonal,
/area/shuttle/supply)
"x" = (
/obj/effect/decal/cleanable/dirt,
/turf/open/floor/iron/shuttle/cargo,
/area/shuttle/supply)
"A" = (
/obj/machinery/power/shuttle_engine/heater{
	dir = 8
	},
/obj/structure/window/reinforced/plasma/spawner/directional/east,
/obj/effect/turf_decal/stripes/line{
	dir = 4
	},
/turf/open/floor/plating/airless,
/area/shuttle/supply)
"D" = (
/turf/closed/wall/mineral/titanium/spaceship/nodiagonal,
/area/shuttle/supply)
"K" = (
/obj/structure/marker_beacon/olive,
/obj/structure/fluff/metalpole/end{
	pixel_x = 32;
	dir = 4
	},
/turf/closed/wall/mineral/titanium,
/area/shuttle/supply)
"P" = (
/obj/structure/marker_beacon/olive,
/turf/closed/wall/mineral/titanium/nodiagonal,
/area/shuttle/supply)
"T" = (
/obj/effect/turf_decal/tile/neutral/diagonal_edge,
/obj/effect/turf_decal/box/white/corners{
	dir = 8
	},
/obj/effect/decal/cleanable/dirt,
/turf/open/floor/iron/dark/diagonal,
/area/shuttle/supply)
"V" = (
/obj/structure/marker_beacon/burgundy,
/obj/structure/fluff/metalpole/end{
	pixel_x = 32;
	dir = 4
	},
/turf/closed/wall/mineral/titanium,
/area/shuttle/supply)
"W" = (
/obj/structure/marker_beacon/burgundy,
/turf/closed/wall/mineral/titanium/nodiagonal,
/area/shuttle/supply)

(1,1,1) = {"
l
a
a
a
l
"}
(2,1,1) = {"
D
A
w
A
D
"}
(3,1,1) = {"
W
o
o
T
P
"}
(4,1,1) = {"
m
o
o
o
m
"}
(5,1,1) = {"
m
i
o
o
m
"}
(6,1,1) = {"
m
u
x
x
b
"}
(7,1,1) = {"
m
T
x
T
m
"}
(8,1,1) = {"
m
o
x
o
m
"}
(9,1,1) = {"
m
i
x
i
s
"}
(10,1,1) = {"
m
u
x
x
m
"}
(11,1,1) = {"
m
o
x
o
m
"}
(12,1,1) = {"
m
o
x
o
m
"}
(13,1,1) = {"
m
i
x
i
m
"}
(14,1,1) = {"
V
m
m
m
K
"}
